################## #####################
###             ## ############   ######
### #### ###### ## ###                ##
### #### ###### ## ### ##### ######## ##
### ##          ## ### #####     #### ##
### #### ###### ## ### ######### #### ##
#   ####           ### ####           ##
### ################## #### ############
###                    #### ############
############### ########### ##       ###
############### ########### #### ### ###
##########           ###### #### ### ###
#      ### ######### ##          ### ###
#### #####       ### ## ### ######## ###
#### ##### ##### ### ## ### ## ##### ###
           ###    ## ###### ##       ###
####################        ############
########################################