####################
##  ## ######### ###
##           ### ###
###### ##### ### ###
###### ##### ### ###
       #####     ###
############ ### ###
############ ###   #
####         ### ###
#### ####### ### ###
#### ####### ##### #
#    ####### ##### #
# ## #######       #
# ## ####### #######
# ##            ####
#### ########## ####
#### ########## ####
##              ####
####  ######### ####
############### ####
